

1111101001010111111010010101
0001101111000011111010010101
1110111000000011111010010101
1100001110011111111010010101
0101010101111011111010010101
1010101010010111111010010101
1111101001010111111010010101
0001101111000011111010010101
1110111000000011111010010101
1100001110011111111010010101
0101010101111011111010010101
1010101010010111111010010101
